a111111111111118
2400000000000002
2111111111111802
2000000000000202
20a1111111180202
2020000000020202
2020200500020202
2020911111170202
2020000000000202
2091111111111702
2000000000000000
9111111111111117