a111111111111118
2420000000000002
2020000000000002
2020000000000002
2020000000000002
2000000000000002
2020000000000002
2020000000000002
2020000000000002
2020000000000002
2000000000000002
9111111111111117