a111111111111118
2000000000000002
2000000000000002
2000000000000002
2000040000000002
2000000000000002
2000000000000002
2000000000000002
2000000000000002
2000000000000002
2000000000000002
9111111111111117