a111110111111118a111110111111118
24000000000000022000000000000002
21111101111118022111110111111802
20000000000002022000000000000202
20a111011118020220a1110111180202
20200000000202022020000000020202
00002005000202000000200500020200
20209101111702022020910111170202
20200000000002022020000000000202
20911101111117022091110111111702
00000000000000000000000000000000
91111101111111179111110111111117
a111110111111118a111110111111118
20000000000000022000000000000002
21111101111118022111110111111802
20000000000002022000000000000202
20a111011118020220a1110111180202
20200000000202022020000000020202
00002005000202000000200500020200
20209101111702022020910111170202
20200000000002022020000000000202
20911101111117022091110111111702
00000000000000000000000000000000
91111101111111179111110111111117