a111110111111118
2400000000000002
2111110111111802
2000000000000202
20a1110111180202
2020000000020202
0000200500020200
2020910111170202
2020000000000202
2091110111111702
0000000000000000
9111110111111117